Hamza Yassine - Chimobi Ekwunife
Hicham El Madani - Zakaria Rabih
Anass Chtioui - Mohamed Ballouchi
Prince Opoku Amaning - Dennis Okeri
Steve Gitema - Idris Adeleye
Abdulrozaq Amusa - Abdellatif Seghir
Houssam Badrane - Youssef Kayk
BARTASA MBITI - Captyn Njenga
Benaiah Raini - Opeyemi Alabi
Kadi Shilumba - Hajar El Mannani
Edna Ametefe - Habeeb Quadri
Amine Atyq - Ayoub Abouchadi
Elijah Adeloye - Wanjiru Wanjiru
Stephen Monari - Ismail Es-Soudaigui
Mongezi Sibande - Graham Martey
Derrick Mungai - Tracy Sambu
Michael Onyekwere - Eveshogweyore Alle
Kofi Annan - Beverly Sam
Bonveture Mbolole - Johnpeter Kigotho
Riliwan Tajudeen - Ridwanullahi Akorede
Nana Kwame Safo - Peter Kwesi Obrempong Stephenson
Soufiane Mazouzi - Hamza Miloudi
George Achieng - Segun Olawale
Hanae Aghoutane - Oladamola Taiwo
Ashlame Sunday - Ronald Kipsang
Rufus Ezugwu - Kingsley Okpo
Goodnews Akpan - Kenechukwu Akubue
Solomon Kassa - Hamdiya Gariba
Lucy Kendi - Adam Tassaft
Akua Serwaa Dankwah - Obed Kwartekwei Quartey Quartey
Karisa Sally - Kofi Awuah
Benjamin Appiah - Perry Timinah
Anas Douiri - Yassine Oujama
Pauline Maina - Mohamed Baillade
Joseph Karanja - Romeo Ndimande
Tiwalade Adegoke - Sandra Uzoukwu
Dagmawi Zekarias - Nasir Degu
Steven Olaebi Miene - Hammed Yakub
Khawla Anoui - Othman Rhajbal
Nandwa Japheth - Nsikakabasi Okon
Brenda Aramis - Maxwell Mutuku
Eric Lenina - Audrey Saru
Lerato Thinane - OLUWAFIKUNAYOMI SALU
Chukwu Stephen - Mourad Elmouhib
Olatunji Oluwadare - Linda Mwarania
Noah Limo - Amine Taouis
Lyte Ennaour - Karim ElHagouchi
Feven Bayu - Leta Malimo
Collins Kimani - Daniel Nyakundi
Pherbish Orwa - Bruce Kimutai
Adeyinka Onatola-Morakinyo - SHEMA Moses
Alamin Akingbade - David Archibong
Silvia Mwingirwa - Loveth Ohinmah
Valentine Mutembei - Amal Miri
Abdelmalek Akhlij - Olusola Aremu
Ridan Hawi - Anass Deroussi
mYcH Mitchele - Ghita Amrani Souhli
Akinola Akinduro - Jimwilly Gacenga
Nicholas Hongo - Felix Kamau
Keamogetse Mohlala - Lesedi Mokoena
Samson Oke - Bernard Baah
Godsway Asamoah - Richard Aroh
Kevin Mwenda - Thabile Mthethwa
Kenan William - Edwin Waweru
Nothemba Tokwe - Michelle DIawara
Afia Owusu-Asare - Emmanuella Asita
Solomon Njogo - Olaiya Oniya
Mohamed Boujelfa - Az-eddine Nader
Ernest Ukogo - Chukwudi Nwaneri
Manirampa Pacifique - Uc David
Faturoti Babawale - Muyiwa Muyiwa Onawale
Esther Mutiria - william maina
Emmanuel Ayettey - Papa Kwasi Safo
Anas Mouak - Yassine Mtejjal
Afia Serwaa Ntosour-Amponsem - Millicent Amegavie
Natnael Asnake - Abderrahmane El Rhasssani
Abdallah Ouahmane - Jude Osam-Sackey
Mathew Koech - Simon Miringu
Mahlet Tilahun - Jonathan Esokawu
Youssef Ibba - kamal miftah
Abdallah Moumni - Taha Hassane
Sam Solomon - Raphael Effiong
El Mahfoud Omary - Erick Kamau
Wisdom Ncube - Zivha Beharie
Sharon Mungania - Odary Odary
Maureen Kwaku - Pedro Muttenda
Micheal Fakolujo - Meriem Kharbouch
Oyinkansola Adebayo - AhmedElmostafa Elamin
Dorcas Litala - Allan Wachira
Teresia Nyakimari - Johnson Johnson
Nepo Munezero - Samuel Kwofie
ismail ouzal - Brahim El Hajji
Mena Ujiri - Johanna Mothata
Emmanuel Kayode - Derrick Muturi
Solomon Felicien - Maroine Nbali
Alaa Damen - Oussama Sakhi
Sikiru Ajanaku - John Muthee
sami jelloun - Juwon Oluwajuwon
Brian Orandi - Rasheed Olaoluwa
Mughtaar Gool - Mogammed Ra-Eez Zardad
Olanrewaju Lawal - Willington Kutar
Adewunmi Adegunwa - Eyoel Bogale
Ifouloussen Rachid - Gabriel Showole
Mary Otuka - Oscar Akwantey Boafo
Enoch Tenkorang - Akintola Akinyele
Shaun Saisi - Ali Belmaaza
Kofi Ntim - John Moses
Joshua Umukoro - Temitayo Daisi-Oso
Fortune Maduwuike - Ayamba Adamu
Oussama El Guennouni - Soufiane El Houmy
Abderrahim Oulmaamer - Amine Bifden
Zouhair Mariouate - Abdul Basit Musah
hicham essaket - Oluwasemilogo Owolabi
Joseph Mariga - Kelvin Miruka
Amine Afilal El Alami - Anas Fadili
Reda Laaouaj - Oghenetega Egwabor
Kelvin Anwenede - Abraham Livinus
Tayo Olowu - Paul Mugo
Ahmed Hlilioune - Azeez Badru
Michael OKO - Emmanuel Ngato
Ganza Moses - Marc Nsanzimfura
Ayoub Sahmi - Langat Moimaritim
Adekunle Eweje - Favour Avwopiabro
Ntokozo Vilakazi - Kgothatso Papo
Vincent Oronimighwu - Abdelkrim Mouyssi
Nicholus Albert - Brian Wachira
Margaret Afia Andoh - Felix Amponsah
Yassine Kaaouachi - Adekunle Hassan
Soukaina Farhan - Charles Karanja
Olusegun Tayo - Mohamed Bassaddouk
Mikiyas Wubshet - Nathnael Shimelis
Mohamed Bensaddik - Mohamed Amine Berguia
Stephen Maina - Lesego Mashabela
Ronny Kerosi - Sophie Olonde
Ralph Okorie - Nwafor Samuel
Hiba Nahed - Oussama Aj Oussama
IFE Ineh - Bisola Adeboye
Zakaria Derkaoui - Eldad Mamo
Antipas Belihu - Nwosu Friday
Abdelhamid Nissoul - Reda Adjar
Adnane Elmoustaghfir - Mohamed El Allouli
Gbolahan Akande - Tobiloba Tobiloba
Josephat Oyoke - Marcelo Onyeukwu
Anania Gebretsion - Zeru Aemero
Victor Nwaogu - Grace Osimen
Tom Nyabuto - Joshua Baka
Simangele Tutubala - Elijah Arhinful
Dagmawi Kassa - Charles Onwuchekwa
Mucyo Niyomugaba Louis Berthrand - Pelumi Dada
Silvia Makau - Nehemiah Adane
HUSSEIN Garane - Benson Muikia
Sonia Twum - Okoye Ogochukwu
Stephen Barracks Asemiah - Ifiemi Igoniseigha
Kehinde Dada - Ahmed Sodiq
Sophie Ododa - Simon Mwangi
Frederick Ndambuki - Austin Onyango
Meryem Dardouri - Omollo Omollo
Kevin Ocholla - Abdelhamid LACHIQ
Salma Doukkane - Nabil Mkadmi
El Khalil Zbir - Oluwatobi Micheal
Diana Yorke - Benjamin Owolabi
Nicholas Ng'anga - Amine Belhayania
Cleveland Ataafi - Soufiane Sadgali
Segun Aremu - Brent Van Schalkwyk
Nevean Omondi - Matt Nyaseda
Emmanuel Arthur - Effah Aboagye
Amine Botza - Oluwatobi Oladoye
LIVINGSTONE OKERO - Mordecai Wambua
Wagner Mushayija - Anas Chahid
Chima Ekoma - Mohammedzahir Zahir
Kawtar Mouaouiya - Richard EsselMensah
Daniel Onyinkwa - Fred Kang'ethe
Victor Kilonzo - Cedric Nsengiyumva Ngabo
Brian Kyalo - Keith Nyaburi
Brian Omwenga - Nozipho Nkosi
Peter Bello - Surprise Moraba
Othman Daha - Mohammed SHAB
Aymen Eddbiri - Adam Ouhliss
Nzewunwa Grace Onyinyechi - Ngumi Mwaura
Kelvin namu - KELVIN KELVIN
hamza Elguemri - Eddie. Wekesa
Hector Macassa - Plantinah Kealeboga Tshukudu
Yemmy Eteng - Progress Gogo-Chinda
Ian Wanjama - Faisal AliAdebambo
Fadwa Elmghaiel - Love Honny
Youssef Oussaid - Youssef Lizdihar
Daniel Egbuluese - Uche Nwuchu
Faith Olotu - Ganiyu Otun
Elorm Heletsi - Benjamin Gyawu
Colile Sibanda - Kolawole Tella
Gift Aghaulor - Faith Kimanthi
Lebogang Manamela - Nonkululeko Faith Sebiloane
Ebenezer Kissiedu - Lewis Mutiso
Mohamed Yassine Addi - Abdellah Lehmadi
Methode Duhujubumwe - Winebald Banituze
Girum Assefa - Minale Wondimu
Ismail Olayemi - David Oladele
Melusi Masilela - Nawfal Sakirda
MICHAEL MURITHI - Qabale Liban
Esther Fagbemi - Joseph Sekhukhune
Sharon Kemboi - Lucky-Willis Mwabi
Roselene Odimgbe - Ayodeji Adewuni
Sarah Wonago - Neftalem Gebremicael
Gikonyo Dennis - Siddiq Tiema
Dawit Yifru - Yunus Minuta
Yusuf Muibi - Oluwadamilola Owolabi
Nicholas Odiwuor - Hassan Kamau
Frank Anin - Daniel Quist
Abdelmalek Kamal - Ismail Ismail
Michael Kimulu - Youssef Oubihi
Mewael Mulu Woldegebriel - Akintope Morondiya
Nhlanhla Moyana - Ali Ait Brahim
Anas Oudadsse - Imane Wakrim
Lilian Okongo - Kevin Kirui
Agatha Mwaniki - Aymane El Allouch
Martinez Esiekpe - Temijopelo Jeje
Jean Remy Ikirezi Inkindi - Muzamiru Kiyaga
Ayoub Douane - Charles Fiati
Younes Darir - Salahdin Bouasil
Godfred Hammond - Sonia Chagusia
Ayoub Lahrech - Hamza Benslimane
Viona Njenga - Arnold Mwangi
Fortune Malaza - Solomon Ovie Okomowho
Ololade Ogunsola - Idowu Okusanya
Miracle Okenna - Razzouk Ayoub
Geofrey Ongeta - Andrew Emmanuel Anim
Jacob Kisotu - Nada Hamdani
Brian Bantu - Yemi Adeyemi
Valentine Ogbuagu - Oseni Matthew
Precious Iwuanyanwu - Quadri Akerele
Yassine Sabri - Ilyass Bacime
Ezekiel Appiah - Eben Ebenezer
Donato Chauque - Njambi Karungari
Franklin Odinaka - Marvellous Divine
John Adebiyi - Banyan Otchere
Karushi Karushi - Victor Kamau
Zayed Bendahou - Mojeed Shittu
Richard Bampoe - Anas Amoury
Saeed Yussif - Goodness Wema
Mohammed Hajoubi - Eric Asare
Pravin Waswa - Zakaria eldahar
Emmanuel Owuor - Kipkoech Beygon
Thomas Manhica - Christopher Makeketa
David Onumonu - Mercy Wahome
Yassir Mzak - Achraf Achraf
John Karenju - Kenneth Kariuki
Faruok Abioye - Olalekan Bankole
Jahath Mwarori - Michael Maina Maina
Ewoma Ozore - KENNEDY WANYOIKE
Kelvin Mabonga - George Ikigu
Matthew Mwangi - Cephas Njoroge
Morakinyo Ezekiel - Hiba Reddaf
Sandra Warugongo - Rechol Kibebe
Ismail Chbani - Noura Ibadah
Yonas Yalew - Samuel GebreSelassie
Andra Mensah - Mohamed Rida Oukili
Kimani Kamau - Walter Mukhwana
Keegan Joubert - Said Ait Bellaid
Mohsine Hourmat Allah - Bilal Eneouisser
ALi Babana El Alaoui - Kuria Ndung'u
Damilola Onanuga - Charif Jazouli
Prince Henry Henry Nii Addy - Bernie Amponsah
Roy Kibata - Stancelaus Lumasia
Titus Obinna Mbanu - Chukwuebuka Ohazulike
Adebayo Akerele - Gift Mathotsi
Oluwajuwon Odunitan - Eliezel Masezerano
Mohcine Maarouf - Pierre Truter
Oluwapelumi Ogunmuyiwa - Fatima Ezzahraa Abbari
Aymane Lamarti - Marlon Gatheru
Younes ait lahsen - Clinton Nyakoe
Murengerantwari James - Antony Munyiri
Hassan BOUSFIHA - Khalid Benhamou
Okiri Oghenetega - Elmehdi Charib
Daniel Ngene - Josphat Kahihia
Assouam Achraf - Lovel Nwafor
Floxy Amede - Halima Adelaja
Tobiloba Adeleke - Karikumutima Honore
el asla faycal - Khalil Ouahmid
Itohan Momodu - Damilare Ogundahunsi
Praise Josiah - Gabriel Emmanuel
Lawal Mustapha Oluwatobi - Uzor Nwachukwu
Neo Ngqikashe - Olayemi Odobo
Josephine Kaggwa - Lawrencia Appiah-Danquah
Odunayo Dauda - Habeeb Ojedokun
Otmane Touhami - Jephthah Zormelo Zormelo
Kevin Omolo - Harold Adjei
Ota Okpogo - Stanley Obianke
Sean Kihiu Kihiu - Djimra NGARLEITA
Chukwunonso Nwankpa - Deborah Ogwuche
Simon Ngei - Funmilayo Fayemi
Noblet Appiah - Pascal Lawson
Desmond Mariwa - Mohamed Riadi
Owusu Vincent - Peter OpokuMensah
Lesedi Shokane - Liisa Makona
Amanda Mkhize - Mustapha Bouhou
Lisa Ogeya - Aderele Adebiyi
Hamza Mahjabi - Daniel Akubada
KALORSOR Alorsor - Miracle Hycient
Ugo Ogadi - Ezekiel Gwamna
Fabian Fabian - Blessed Adesina
Babalola Taiwo - Simon Osime
Khayalethu Shezi - Joel Kudamo
Benjamin Okusanya - Azeez Adebayo
Melline Kathomi - Hadija Mahmoud
Frederick Napey - Carl Birkenstock
James Daniel - Mouad Hafiane
Kelvin Tetteh Mangortey - Hamza Yasri
Nicholas Naidu - Benitha NGUNGA
Whitney Ologi - Christopher Kahura
Olayya Mansour - Daniel Watchman
Nigel Waswa - Emmanuel Nyabuto
Monicah Mugure - Wandia Muhoro
Temitope Odukoya - Williams Michael
Mohammed Boukar - Mostafa Rafiki
Othmane Kasmi Kasmi - Ahmed Hallal
Saad Amraoui - Justus Ndegwa
Lynnette Orwa - Issam Ouzali
Keitumetse Kgatlhanye - Brian Otieno
Fawas Iwayemi - Praise Afolabi
Othmane Azelmat - Amine Ouahouah
Haitam Hamou - Timothy Ofie
Lesego Nkosi - Sadik Adams
Mustapha Yinusa - Abimbola Salami
Inyene Etoedia - Owoyemi Owoeye
Naila Ur Rahman - Ali Muhammed Adam
Jes Arku - Omo Ikheloa
Ntsako Sambo - Elias Abafita
Mohamed amine Amine - Cwenga Mkentane
Katlego Koma - Joshua Eze
Priscilla Ng'endo - Razak Dimmie
Tomiwa Akinola - Oluwadamilare Yusuf
Walid Jalaly - Olayinka Animashaun
Sizwe Ndlovu - Dan Lewis
Lucky Baraka - Emmanuel Igwe
Soufiane Ait ammou - Chidinma Okoro
Joseph Muthoni - Emmanuel Nwogu
Moses Wakuloba - Edem Dufe
Yassine Moussafir - Dahhoum Dahhoum
Emmanuel Odero - Beatrice Mukii
Gilbert Kusi - Mubarak Agbaje
Timothy Werunga - Ben Owusu-Antwi
Dennis Nyamwamu - Philemon Ocloo
Samuel Guish - Joseph Karanja
Odiwonma Chidindu - Seldorna Kullie
Chris Parey - Gift Aterezi
Nunya Apetsi - Tega Echeo
Nombuso Simelane - Yinka Akindele
Valrite Ehachi - Youssef Aboulouafa
Reuben Abdul - Ian Gongo
Hiba Ait Kessou - Benyarko Ahmed
Hayyalu Temesgen - Oluwatobiloba Otun
comfort Shingange - Mercy Akpan
Nothando Sibanyoni - Dondou ABIYI
Taha Elmahsoune - Leslie Asante
Michael Gnaho - Brian Sechelo
Joshua Olagbemiro - Joepackins Owino
Issam Hamdoune - Ugochukwu Okpoko
Abdulmalik Lawal - Jonathan Noble
Prosper Atu Atu - Idongesit Ekanem
Aerin Lombard - Khehla Dlamini
Precious Oloye - Kale Francis
Badr Naoumi - PrinceBrown Ojezua
Adeshina Olorogun - Simon Machira
MCF Idrissi - Dalvin Onyango
Kiprotich Kibor - Kevin Gatamu
Temo Percy Goitsione Khumo Maphologela - Claire Hawi
Souhail ouichou - Oumaima Maliki
Isaac Namango - Louie Otieno
Malik Ballans - Polycarp Gitonga
james ndegwa - Quinto Acquino
Ayoub Bigharassine - Boluwatife Fasina
Silas Elehibiri - Hiba Cherifi
Favour Oladele - Kawthar Elkis
Evelyn Boora - Rudzani Matidze
Moses Esumei - Kgaugelo Shai
Joshua Ngmertey - Tunde Ogunmodede
Saad El Mouaffak - Mohie Eddine Lakhdar
Ayyoub EL Moumen - Vuyisile Lehola
BADREDDINE NEJAA - El Mehdi Azghoul
Ahmed Sahbeddine - Salim Abdessamad
Kevin Asena - Ilyass Azyaiz
Iyanu Dayisi - James Mark
Hamza Semlali - Abel Asiedu
Israel Oyetola - OBIOHA Clinton
Macpherson Macpherson - El Mehdi Soussi
Surprise Awofemi - Sholafunmi Adewara
Murewa Abiodun - Oluwatofunmi Famuwagun
Aminu Yiwere - EVANS MULEI
Lizzie Akinyi - Mercy kariuki
Louay Belhaj - Rim Chafik
Ian Gichengo - Zaid Said
Kennedy Asare - Lisa Dade
Michael Sylvester - kamau l